511111111111111111111111111111111111111111111111111111111116
3HHHHHHHHHHH0S...0M..........HHHHM..........HHHHM..........4
3HHHHHHHHHHH0....0...........HHHH...........HHHH...........4
3HHHHHHHHHHH0....0...........HHHH...........HHHH...........4
3HHHHHHHHHHH0....0...........HHHH...........HHHH...........4
3HHHHHHHHHHH0S...0...........HHHH...........HHHH...........4
3HHHHHHHHHHH0....0...........HHHH...........HHHH...........4
3HHHHHHHHHHH0P...0...........HHHH...........HHHH...........4
3HHHHHHHHHHH0....0...........HHHH...........HHHH...........4
3000000000000S...0000000000000000000000000000000000000000004
3R...R...R.......R...R...R...R...R...R...R...R...R...R...R.4
3.....................................A....................4
3..........................................................4
3............S.............................................4
3HHHHHHHHHHH0....0000000000000000000000000000000000000000004
3HHHHHHHHHHH0....0HHHHHHHHHHHHHHHHHHHHHHHHHHHHHHHHHHHHHHHHH4
3N.........H0....0HHHHHHHHHHHHHHHHHHHHHHHHHHHHHHHHHHHHHHHHH4
3..........H0S...0HHL...............HHHHHHL...............H4
3..........H0....0HH................HHHHHH................H4
3..........H0....0HH................HHHHHH................H4
3..........H0....0HH................HHHHHH................H4
3..........H0S...0HH................HHHHHH................H4
3..........H0....0HH................HHHHHH................H4
3..........H0....0HH................HHHHHH................H4
3..........H0....0HH................HHHHHH................H4
3..........H0S...0HH................HHHHHH................H4
3..........H0....0HH................HHHHHH................H4
3..........H0....0HH................HHHHHH................H4
3HHHHHHHHHHH0....0HH................HHHHHH................H4
3HHHHHHHHHHH0S...0HHHHHHHHHHHHHHHHHHHHHHHHHHHHHHHHHHHHHHHHH4
3HHHHHHHHHHH0....0HHHHHHHHHHHHHHHHHHHHHHHHHHHHHHHHHHHHHHHHH4
3HHHHHHHHHHH0....0000000000000000000000000000000000000000004
3N.........H0....R...R...R.P.R...R...R...R...R...R...R...R.4
3..........H0S.............................................4
3..........H0...............................P..............4
3..........H0..............................................4
3..........H0....000000000000000000000EEEEEEEEEEEEEEEEEEEEEE
3..........H0S...000000000000000000000EEEEEEEEEEEEEEEEEEEEEE
3..........H0....000000000000000000C00EEEEEEEEEEEEEEEEEEEEEE
3..........H0....000000000000000000000EEEEEEEEEEEEEEEEEEEEEE
3..........H0....000000000000000000000EEEEEEEEEEEEEEEEEEEEEE
3..........H0S...000000000000000000000EEEEEEEEEEEEEEEEEEEEEE
3..........H0....000000000000000000000EEEEEEEEEEEEEEEEEEEEEE
3..........H0....0000000F0000000000000EEEEEEEEEEEEEEEEEEEEEE
3HHHHHHHHHHH0....000000000000000000000EEEEEEEEEEEEEEEEEEEEEE
3HHHHHHHHHHH0S...000000000000000000000EEEEEEEEEEEEEEEEEEEEEE
3N.........H0..A.000000000000000000C00EEEEEEEEEEEEEEEEEEEEEE
3..........H0....000000000000000000000EEEEEEEEEEEEEEEEEEEEEE
3..........H0....000000000000000000000EEEEEEEEEEEEEEEEEEEEEE
3..........H0S...000000000000000000000EEEEEEEEEEEEEEEEEEEEEE
3..........H0....000000000000000000000EEEEEEEEEEEEEEEEEEEEEE
3..........H0....000000000000000000000EEEEEEEEEEEEEEEEEEEEEE
3..........H0....000000000000000000000EEEEEEEEEEEEEEEEEEEEEE
3..........H0S...000000000000000000000EEEEEEEEEEEEEEEEEEEEEE
3..........H0....0EEEEEEEEEEEEEEEEEEEEEEEEEEEEEEEEEEEEEEEEEE
3..........H0....0EEEEEEEEEEEEEEEEEEEEEEEEEEEEEEEEEEEEEEEEEE
3..........H0....0EEEEEEEEEEEEEEEEEEEEEEEEEEEEEEEEEEEEEEEEEE
3..........H0S...0EEEEEEEEEEEEEEEEEEEEEEEEEEEEEEEEEEEEEEEEEE
3HHHHHHHHHHH0....0EEEEEEEEEEEEEEEEEEEEEEEEEEEEEEEEEEEEEEEEEE
722222222222222222EEEEEEEEEEEEEEEEEEEEEEEEEEEEEEEEEEEEEEEEEE
QQQQQQQQQQQQQQQQQQQQQQQQQQQQQQQQQQQQQQQQQQQQQQQQQQQQQQQQQQQQ
QQQQQQQQQQQQQQQQQQQQQQQQQQQQQQQQQQQQQQQQQQQQQQQQQQQQQQQQQQQQ