511111111111111111111111111111111111111111111111111111111116
300000000000000000000000000000000000000000000000000000000004
300000000000000000000000000000000000000000000000000000000004
300000000000000000000000000000000000000000000000000000000004
300000000000000000000000000000000000000000000000000000000004
300000000000000000000000000000000000000000000000000000000004
300000000000000000000000000000000000000000000000000000000004
300000000000000000000000000000000000000000000000000000000004
300000000000000000000000000000000000000000000000000000000004
300000000000000000000000000000000000000000000000000000000004
300000000000000000000000000000000000000000000000000000000004
300000000000000000000000000000000000000000000000000000000004
300000000000000000000000000000000000000000000000000000000004
300000000000000000000000000000000000000000000000000000000004
300000000000000000000000000000000000000000000000000000000004
300000000000000000000000000000000000000000000000000000000004
300000000000000000000000000000000000000000000000000000000004
300000000000000000000000000000000000000000000000000000000004
300000000000000000000000000000000000000000000000000000000004
300000000000000000000000000000000000000000000000000000000004
300000000000000000000000000000000000000000000000000000000004
300000000000000000000000000000000000000000000000000000000004
300000000000000000000000000000000000000000000000000000000004
300000000000000000000000000000000000000000000000000000000004
300000000000000000000000000000000000000000000000000000000004
300000000000000000000000000000000000000000000000000000000004
300000000000000000000000000000000000000000000000000000000004
300000000000000000000000000000000000000000000000000000000004
300000000000000000000000000000000000000000000000000000000004
300000000000000000000000000000000000000000000000000000000004
300000000000000000000000000000000000000000000000000000000004
300000000000000000000000000000000000000000000000000000000004
300000000000000000000000000000000000000000000000000000000004
300000000000000000000000000000000000000000000000000000000004
300000000000000000000000000000000000000000000000000000000004
300000000000000000000000000000000000000000000000000000000004
300000000000000000000000000000000000000000000000000000000004
300000000000000000000000000000000000000000000000000000000004
300000000000000000000000000000000000000000000000000000000004
300000000000000000000000000000000000000000000000000000000004
300000000000000000000000000000000000000000000000000000000004
300000000000000000000000000000000000000000000000000000000004
300000000000000000000000000000000000000000000000000000000004
300000000000000000000000000000000000000000000000000000000004
300000000000000000000000000000000000000000000000000000000004
300000000000000000000000000000000000000000000000000000000004
300000000000000000000000000000000000000000000000000000000004
300000000000000000000000000000000000000000000000000000000004
300000000000000000000000000000000000000000000000000000000004
300000000000000000000000000000000000000000000000000000000004
300000000000000000000000000000000000000000000000000000000004
300000000000000000000000000000000000000000000000000000000004
300000000000000000000000000000000000000000000000000000000004
300000000000000000000000000000000000000000000000000000000004
300000000000000000000000000000000000000000000000000000000004
300000000000000000000000000000000000000000000000000000000004
300000000000000000000000000000000000000000000000000000000004
300000000000000000000000000000000000000000000000000000000004
300000000000000000000000000000000000000000000000000000000004
722222222222222222222222222222222222222222222222222222222228
QQQQQQQQQQQQQQQQQQQQQQQQQQQQQQQQQQQQQQQQQQQQQQQQQQQQQQQQQQQQ
QQQQQQQQQQQQQQQQQQQQQQQQQQQQQQQQQQQQQQQQQQQQQQQQQQQQQQQQQQQQ