HHHHHHHHHHHHHHHHHHHHHHHHHHHHHV
HHHHHHHHHHHHHHHHHHHHHHHHHHHHVH
VHSSSSSSSSSSSSSSSSSSHHHHHHHHVV
VSSSSSSSSSSSSSSSSSSSSVSSSSSSSH
VSSSSSSSSSSSSSSSSSSSSVSSSSSSSV
VSSSSSSSSSSSSSSSSSSSSVSSSSSSSH
VSSSSSSSSSSSSSSSSSSSSSSSSSSSSV
VSSSSSSSSSSSSSSSSSSSSSSSSSSSSH
VSSSSSSSSSSSSSSSSSSSSSSSSSSSVV
VSSSSSSSSSSSSSSSSSSSSSSSSSSSVH
VSSSSSSSSSSSSSSSSSSSSSSSSSSVVV
VSSSSSSSSSSSSSSSSSSSSSSSSSSSVH
VSSSSSSSSSSSSSSSSSSSSSSSSSSSVV
VSSSSSSSSSSSSSSSSSSSSSSSSSSSVH
VSSSSSSSSSSSSSSSSSSSSSSSSSSSVV
VSSSSSSSSSSSSSSSSSSSSSSSSSSSSH
VSSSSSSSSSSSSSSSSSSSSSSSSSSSSV
VSSSSSSSSSSSSSSSSSSSSSSSSSSSSH
VSSSSSSSSSSSSSSSSSSSSSSSSSSSSV
VSSSSSSSSSSSSSSSSSSSSSSSSSSSSH
VSSSSSSSSSSSSSSSSSSSSSSSSSSSSV
VSSSSSSSSSSSSSSSSSSSSSSSSSSSSH
VSSSSSSSSSSSSSSSSSSSSSSSSSSSSV
SSSSSSSSSSSSSSSSSSSSSSSSSSSSSH
SSSSSSSSSSSSSSSSSSSSSSSSSSSSSV
SSSSSSSSSSSSSSSSSSSSSSSSSSSSSH
SSSSSSSSSSSSSSSSSSSSSSSSSSSSSV
SSSSSSSSSSSSSSSSSSSSSSSSSSSSSH
VVSSSSSSSSSSSSSSSSSSSSSSSSSHHV
VVSSSSSSSSSSSSSSSSSSSSSSSSSHHV
QQQQQQQQQQQQQQQQQQQQQQQQQQQQQQ
QQQQQQQQQQQQQQQQQQQQQQQQQQQQQQ